----g---g---
-b---b----r-
-b--b-------
--g--b--g-b-
-g----------
-bb--b--b---
0 1
0
