------------
---------k--
-k----------
-------k----
--------k---
--k---------
----------k-
k-----------
------------
0 0
0
